#       #                #####
  @     #                    #
        #        #            
                             
      #                      #
#######           ############
#######           ############
#######           ############
#######           ############
#######           ############
