########################################################################
###############################################################    $  ##
###############################################################       ##
###############################################################       ##
####################################################### F ######wwww####
########################             ########     #####   ######wwww####
#R              @         w           ######       ####   ######    ####
#                         w     F                  ####   ####        ##
#                                                  ####   ####I      I##
##    ##################     ww      ########    ######   ####        ##
##    ##################             ########    ######               ##
##    #########################   ###########    ###############    ####
##     ww  ww  ww    ##########   ######             ##########      ###
##                ww                          E      ##########      ###
#####w  w  w  w   ww                      w          ##########R    R###
#####w  w  w  w #####    ##               w          ##########      ###
#####     ###########    #####     ##     w     F      ########      ###
#####w    ###########    #####     ##                  ########      ###
#####w     C             #####  R  ###                 ########      ###
#####                     ####     ####         ww     ########      ###
#####  C              E   ##############                             ###
###################       ###############                            ###
########################################################################
